2,2,2,2,2,2,2,2,2,2,2
2,2,2,2,5,21,5,2,2,2,2
2,2,5,5,5,5,5,5,5,2,2
2,2,5,2,2,5,2,2,5,2,2
2,2,5,2,5,5,5,2,5,2,2
2,2,5,2,5,5,5,2,5,2,2
2,2,19,5,5,2,5,5,5,2,2
2,2,5,2,5,5,5,2,5,2,2
2,2,5,2,5,5,5,2,5,2,2
2,2,5,2,2,5,2,2,5,2,2
2,2,5,5,5,5,5,5,5,2,2
2,2,2,2,5,5,5,2,2,2,2
2,2,2,2,2,2,2,2,2,2,2
