2,2,2,2,2,2,2,2,2
2,2,21,2,2,5,5,5,2
2,2,5,2,2,5,2,2,2
2,2,5,2,2,5,5,2,2
2,2,5,2,2,2,5,2,2
2,2,9,2,2,5,5,2,2
2,5,5,5,2,2,5,2,2
2,5,2,5,5,5,5,2,2
2,5,2,5,2,5,2,2,2
2,5,2,5,5,5,5,5,2
2,2,2,2,2,2,2,2,2
