2,2,2,2,2,2,2,2,2,2
2,2,2,2,5,5,2,2,2,2
2,5,5,5,5,5,2,2,2,2
2,5,5,2,2,2,2,2,2,2
2,5,5,5,5,5,5,13,2,2
2,5,5,5,5,5,5,13,2,2
2,2,2,2,2,2,2,5,2,2
2,5,21,5,5,5,5,5,2,2
2,5,5,5,5,5,5,5,2,2
2,2,2,2,2,2,2,2,2,2
